/____________\/____________\
]............[]............[
]./--\./---\.[]./---\./--\.[
]@[  ].[   ].[].[   ].[  ]@[
].<__>.<___>.<>.<___>.<__>.[
]..........................[
]./--\./\./------\./\./--\.[
].<__>.[].<__\/__>.[].<__>.[
]......[]....[]....[]......[
<----\.[<--\ [] /-->]./---->
     ].[/__> <> <__\].[     
     ].[]          [].[     
     ].[] /--++--\ [].[     
_____>.<> [      ] <>.<_____
      .   [      ]   .      
-----\./\ [      ] /\./-----
     ].[] <______> [].[     
     ].[]          [].[     
     ].[] /------\ [].[     
/____>.<> <__\/__> <>.<____\
]............[]............[
]./--\./---\.[]./---\./--\.[
].<_\].<___>.<>.<___>.[/_>.[
]@..[].......  .......[]..@[
<-\.[]./\./------\./\.[]./->
/_>.<>.[].<__\/__>.[].<>.<_\
]......[]....[]....[]......[
]./----><--\.[]./--><----\.[
].<________>.<>.<________>.[
]..........................[
<__________________________>